Species Code	Species Name
Aaga	Agaricia agaricites
Aarc	Aplysina archeri
Aasa	Avrainvillea asarifolia
Aatl	Antipathes atlantica
Abar	Antipathes barbadensis
Aber	Actinia bermudensis
Abra	Amphiroa brasiliana
Acal	Acetabularia calyculus
Acan	Acanthophora sp.
Acau	Aplysina cauliformis
Acer	Acropora cervicornis
Acet	Acetabularia sp.
Acla	Agelas clathrodes
Acom	Amphimedon compressa
Acon	Agelas conifera
Acre	Acetabularia crenulata
Acro	Acropora sp.
Adis	Agelas dispar
Aele	Actinoporus elegans
Aell	Avrainvillea elliotii
Afis	Aplysina fistularis
Afra	Agaricia fragilis
Aful	Aplysina fulva
Agar	Agaricia sp.
Agel	Agelas sp.
Agra	Agaricia grahamae
Ahan	Amphiroa hancockii
Ahir	Antipathes hirta
Ahum	Agaricia humilis
Akre	Anthopleura krebsi
Alac	Aplysina lacunosa
Alam	Agaricia lamarcki
Alen	Antipathes lenta
Alon	Avrainvillea longicaulis
Amag	Astropyga magnifica
Amfr	Amphiroa fragilissima
Amir	Alicia mirabilis
Amph	Amphiroa sp.
Anad	Anadyomene sp.
Anam	Anamobaea sp.
Anba	Anotrichum barbatum
Angr	Antipathes gracilis
Anig	Avrainvillea nigricans
Anoc	Arachnanthus nocturnus
Anti	Antipathes sp.
Aors	Anamobaea orstedii
Apal	Acropora palmata
Apen	Antipathes pennacea
Aply	Aplysina sp.
Apro	Acropora prolifera
Araw	Avrainvillea rawsonii
Arig	Amphiroa rigida
Asal	Anadyomene saldanhae
Asch	Agelas schmidti
Asol	Astrangia solitaria
Aspi	Acanthophora spicifera
Aste	Anadyomene stellata
Asyd	Ascidia sydneiensis
Atag	Aiptasia tagetes
Atan	Antipathes tanacetum
Atax	Asparagopsis taxiformis
Aten	Agaracia tenuifolia
Atri	Amphiroa tribulus
Aund	Agaricia undata
Avar	Anthosigmella varians
Avra	Avrainvillea sp.
Awie	Agelas wiedenmyeri
Aypt	Ayptasia sp.
Azeb	Arca zebra
Bala	Balanophyllia sp.
Bann	Bartholomea annulata
Bart	Bartholomea sp.
Basb	Briareum asbestinum
Bbru	Bispira brunnea
Bflo	Balanophyllia floridana
Bgra	Bunodosoma granuliferum
Bmin	Bugula minima
Bmon	Bostrychia montagnei
Bnig	Botrylloides nigrum
Boer	Batophora oerstedii
Botr	Botrylloides sp.
Bous	Botryllus sp.
Bpen	Bryopsis pennata
Bplu	Bryopsis plumosa
Bpyr	Botryocladia pyriformis
Bria	Briareum sp.
Brni	Branchiomma nigromaculata
Bsub	Bracebrigdia subsulcata
Bten	Bostrychia tenella
Btri	Bryothamnion triquetrum
Btur	Bugula turrita
Bvar	Bispira variegata
Caer	Chaetomorpha aerea
Call	Callyspongia sp.
Cama	Caryophyllia maculata
Capr	Caulerpa prolifera
Carb	Cladocora arbuscula
Cary	Caryophyllia sp.
Case	Caulerpa sertularioides
Casi	Canda simplex
Caul	Caulerpa sp.
Cbar	Cymopolia barbata
Cbre	Colpophyllia breviserialis
Ccan	Clathrina canariensis
Ccar	Cliona caribbaea
Ccla	Centroceras clavulatum
Ccor	Callithamnion cordatum
Ccra	Chaetomorpha crassa
Ccup	Caulerpa cupressoides
Cdeb	Cladocora debilis
Cdec	Codium decorticatum
Cdel	Cliona delitrix
Cden	Caulibugula dendrograpta
Cent	Centroceras sp
Cera	Ceramium sp.
Cflo	Caryophyllia flos
Cgig	Condylactis gigantea
Chae	Chaetomorpha sp.
Chon	Chondrilla sp.
Chry	Chrysymenia sp.
Cimm	Colangia immersa
Cina	Cinachyra sp.
Cint	Codium intertextum
Cirr	Coelothrix irregularis
Cist	Codium isthmocladum
Clad	Cladopsammia sp.
Clan	Caulerpa lanuginosa
Clat	Clathria sp.
Clav	Clavelina sp.
Cleu	Cirrhipathes leutkeni
Clin	Chaetomorpha linum
Clio	Cliona sp.
Clit	Chondria littoralis
Clla	Cliona langae
Clpr	Cladophora prolifera
Clra	Cladophora sp.
Clut	Cladocephalus luteofuscus
Cmac	Cladophoropsis macromeres
Cmag	Contarinia magdae
Cmex	Caulerpa mexicana
Cmin	Chnoospora minima
Cmyr	Cystoseira myrica
Cnat	Colpophyllia natans
Cnit	Ceramium nitens
Cnuc	Chondrilla nucula
Cocc	Cladosiphon occidentalis
Codi	Codium sp.
Coen	Coenocyathus sp.
Cola	Colangia sp.
Colp	Colpophyllia sp.
Cond	Condylactis sp.
Cpar	Champia parvula
Cpas	Caulerpa paspaloides
Cpen	Chamaedoris peniculum
Cpic	Clavelina picta
Cpli	Callyspongia plicifera
Cpod	Calyx podatypa
Cpro	Caulerpa prolifera
Cpue	Clavelina puertosecensis
Crac	Caulerpa racemosa
Crep	Codium repens
Crib	Cribochacina sp.
Crii	Carijoa riisei
Csal	Champia salicornioides
Cser	Caulerpa serrulata
Csim	Colangia simplex
Csin	Colpomenia sinuosa
Csub	Clypeaster subdepressus
Ctax	Caulerpa taxifolia
Cten	Chondria tenuissima
Ctri	Calliactis tricolor
Cvag	Callyspongia vaginalis
Cvas	Cribrochalina vasculum
Cver	Caulerpa verticillata
Dant	Diadema antillarum
Dbai	Dasya baillouviana
Dbar	Dictyota bartayresii
Dber	Distaplia bermudensis
Dcar	Discosoma carlgreni
Dcav	Dictyosphaeria cavernosa
Dcer	Dictyota cervicornis
Dcil	Dictyota ciliolata
Dcli	Diploria clivosa
Dcon	Didemnum conchyliatum
Dcor	Distaplia corolla
Dcra	Dudresnaya crassa
Dcyl	Dendrogyra cylindrus
Ddel	Dictyopteris delicatula
Ddic	Dictyota dichotoma
Ddiv	Dictyota divaricata
Derb	Derbesia sp.
Dgla	Diplosoma glandulosum
Dhar	Dasya harveyi
Dich	Dichocoenia sp.
Dict	Dictyota sp.
Dide	Didemnum sp.
Diia	Dictyosphaeria sp.
Diis	Dictyopteris sp.
Dija	Dictyopteris jamaicensis
Dila	Diplastrella sp.
Dipl	Diploria sp.
Djam	Dictyota jamaicensis
Djol	Dictyopteris jolyana
Djus	Dictyopteris justii
Dlab	Diploria labyrinthiformis
Dlin	Dictyota linearis
Dmeg	Diplastrella megastellata
Dmer	Dictyota mertensii
Dneg	Discosoma neglecta
Dnod	Diodogorgia nodulifera
Docc	Dictyurus occidentalis
Doce	Dictyosphaeria  ocellata
Dost	Derbesia osterhoutii
Drii	Desmophyllum riisei
Drub	Davidaster rubinogosa
Dsan	Discosoma sanctithomae
Dsim	Digenia simplex
Dste	Dichocoenia stellaris
Dsto	Dichocoenia stokesii
Dstr	Diploria strigosa
Dvan	Didemnum vanderhorsti
Dver	Dasycladus vermicularis
Eant	Eupogodon antillarum
Ebah	Erylus bahamensis
Ebar	Ellisella barbadensis
Ecal	Eunicea calyculata
Ecar	Erythropodium caribaeorum
Ecla	Eunicea clavigera
Ecra	Eupolymnia crassicornis
Ecru	Epicystis crucifer
Eelo	Ellisella elongata
Efas	Eusimilia fastigiata
Efer	Ectyoplasia ferox
Efle	Enteromorpha flexuosa
Efus	Eunicea fusca
Eisi	Eucheuma isiforme
Elac	Eunicea laciniata
Elun	Echinometra lucunter
Emam	Eunicea mammosa
Eobs	Eudistoma obscuratum
Epal	Eunicea palmeri
Epin	Eunicea pinta
Eryt	Erythropodium sp.
Esuc	Eunicea succinea
Etou	Eunicea tourneforti
Etri	Eucidaris tribuloides
Etur	Ecteinascidia turbinata
Eudi	Eudistoma sp.
Euni	Eunicea sp.
Eusm	Eusmilia sp.
Ever	Ernodesmis verticillata
Evir	Echinometra viridis
Ffra	Favia fragum
Fhux	Filograna huxleyi
Fteg	Flahaultia tegetiformis
Gace	Gelidiella acerosa
Gala	Galaxaura sp.
Gann	Guynia annulata
Gcer	Gracilaria cervicornis
Gcur	Gracilaria curtissiae
Gdam	Gracilaria damaecornis
Gdom	Gracilaria domingensis
Geli	Gelidium sp.
Gfla	Gorgonia flabellum
Gglo	Grifithsia globulifera
Gmam	Gracilaria mammillaris
Gmar	Galaxaura marginata
Gmin	Gardineria minor
Gnep	Geodia neptuni
Gobl	Galaxaura oblongata
Goma	Gorgonia mariae
Gorg	Gorgonia sp.
Gpus	Gelidium pusillum
Grac	Gracilaria sp.
Gsub	Galaxaura subverticillata
Gtik	Gracilaria tikvahiae
Gven	Gorgonia ventalina
Haca	Halisarca sp.
Hali	Halimeda sp.
Haly	Halymenia sp.
Hbai	Halophila baillonis
Hboe	Hydrolithon boergensenii
Hcer	Hypnea cervicornis
Hcla	Hydroclathrus clathratus
Hcop	Halimeda copiosa
Hcuc	Helioseris cucullata
Hdis	Halimeda discoidea
Hdup	Haloplegma duperreyi
Heme	Hemectyon sp.
Hfee	Hippopodina feegeensis
Hfer	Hemectyon ferox
Hgib	Heterosiphonia gibbesii
Hgor	Halimeda goreaui
Hhel	Holopsamma helwigi
Hinc	Halimeda incrassata
Hlac	Halimeda lacrimosa
Hmon	Halimeda monile
Hmus	Hypnea musciformis
Hopu	Halimeda opuntia
Hpen	Hypnogorgia pendula
Hrub	Haliclona rubens
Hspo	Hydroides spongicola
Hsub	Haliptilon subulatum
Htun	Halimeda tuna
Huat	Heterogorgia uatumani
Hyps	Hypsicomus sp.
Ibir	Iotrochota  birotulata
Ifel	Ircinia felix
Iotr	Iotrochota sp.
Irci	Ircinia sp.
Irig	Isophyllastrea rigida
Isch	Iciligorgia schrammi
Isia	Isophyllia sp
Isin	Isophyllia sinuosa
Isop	Isophyllastrea sp.
Istr	Ircinia strobilina
Jadh	Jania adherens
Jani	Jania sp.
Jrub	Jania rubens
Klim	Kallymenia limminghii
Lasp	Leucandra aspera
Laur	Laurencia sp.
Lbar	Leucetta barbata
Lcer	Liagora ceranoides
Lcon	Lithophyllum congestum
Lcor	Lebrunia coralligens
Lcuc	Leptoseris cucullata
Ldan	Lebrunia danae
Lebr	Lebrunia sp.
Lept	Leptoseris sp.
Lfar	Liagora farinosa
Lheb	Lophogorgi hebes
Liag	Liagora sp.
Lint	Laurencia intricata
Lmed	Loimia medusa
Lmin	Lophogorgi miniata
Lmuc	Liagora mucosa
Lobo	Lobophora sp.
Lobt	Laurencia obtusa
Lpap	Laurencia papillosa
Lpin	Liagora pinnata
Lpoi	Laurencia poitei
Lric	Lignella richardii
Lvar	Lobophora variegata
Lvir	Lophogorgi virgulata
Lwil	Lytechinus williamsi
Lyva	Lytechinus variegatus
Maca	Meristiella acanthocladum
Madr	Madracis sp.
Malc	Millepora alcicornis
Mali	Mycetophyllia aliciae
Mang	Mussa angulosa
Mani	Manicina sp.
Mann	Montastrea annularis
Mare	Manicina areolata
Mart	Martensia sp
Matl	Muricea atlantica
Mbar	Monanchora barbadensis
Mboe	Microdictyon boergesenii
Mcav	Montastrea cavernosa
Mcom	Millepora complanata
Mdan	Mycetophyllia danaana
Mdec	Madracis decactis
Mean	Meandrina sp.
Mech	Meristiella echinocarpum
Mega	Megalomma sp.
Melo	Muricea elongata
Memb	Membranipora sp.
Meri	Meristiella sp.
Mfav	Montastraea faveolata
Mfer	Mycetophyllia ferox
Mfla	Muriceopsis flavida
Mfor	Madracis formosa
Mfra	Montastraea franksi
Mgel	Meristiella gelidium
Micr	Microdictyon sp.
Mill	Millepora sp.
Mlae	Mycale laevis
Mlam	Mycetophyllia lamarckiana
Mlax	Mycale laxissima
Mmar	Microdictyon marinum
Mmay	Manicina mayori
Mmea	Meandrina meandrites
Mmes	Mesophyllum mesomorphum
Mmir	Madracis mirabilis
Mmur	Muricea muricata
Mont	Montastrea sp.
Mpav	Martensia pavonia
Mpen	Muricea pendula
Mpet	Muriceopsis petila
Mpha	Madracis pharensis
Mpin	Muricea pinnata
Mree	Mycetophyllia reesi
Msex	Mellita sexiesperforata
Msqu	Millepora squarrosa
Msty	Myrmekioderma styx
Mula	Muricea laxa
Mung	Monanchora unguifera
Muri	Muricea sp.
Mven	Meoma ventricosa
Myca	Mycale sp.
Myce	Mycetophyllia sp.
Nann	Neomeris annulata
Nare	Niphates areolata
Ndig	Niphates digitalis
Nere	Niphates erecta
Ngor	Nicella goreaui
Nice	Nicella sp.
Niph	Niphates sp.
Nnol	Neofibularia nolitangere
Nnud	Notaulax nudicollis
Nocc	Notaulax occidentalis
NoID	Unidentified species
Npor	Neospongodes portoricensis
Nsch	Nitella schmitti
Nspe	Neogoniolithon spectabile
Nstr	Neogoniolithon strictum
Obar	Oceanapia bartschi
Ocul	Oculina sp.
Odif	Oculina diffusa
Orob	Oculina robusta
Osec	Ochtodes secundiramea
Oten	Oculina tenella
Oval	Oculina valenciennesi
Ovar	Oculina varicosa
Paca	Pandaros acanthifolium
Pace	Pseudopterogorgia acerosa
Padi	Padina sp.
Paly	Palythoa sp.
Pama	Phorbas amaranthus
Pame	Phyllangia americana
Panc	Pterogorgia anceps
Pang	Plakortis angulospiculatus
Past	Porites astreoides
Pbip	Pseudo. bipurata
Pbla	Pseudopterogorgia blanquillensis
Pboe	Padina boergesenii
Pbra	Porites branneri
Pcap	Penicillus capitatus
Pcar	Palythoa caribaeorum
Pcit	Pterogorgia citrina
Pcol	Porites colonensis
Pcor	Phormidium corallyticum
Pcra	Pseudoceratina crassa
Pcru	Pseudoplexaura crucis
Pdeb	Polycavernosa debilis
Pdef	Paracyathus defilippi
Pdic	Plexaurella dichotoma
Pdiv	Porites divaricata
Pdum	Penicillus dumetosus
Pebo	Peyssonnelia boergesenii
Peli	Pseudopterogorgia elizabethae
Peni	Penicillus sp.
Petr	Petrosia sp.
Pexp	Peyssonnelia exp???
Peys	Peyssonnelia sp.
Pfla	Psuedoplexaura flagellosa
Pfle	Plexaura flexuosa
Pflo	Phacelocyathus flos
Pfur	Porites furcata
Pgra	Palythoa grandis
Pgri	Plexaurella grisea
Pgua	Pterogorgia guadalupensis
Pgym	Padina gymnospora
Phcr	Phymanthus crucifer
Phfl	Phyllactis flosculifera
Phom	Plexaura homomalla
Pjam	Padina jamaicensis
Plex	Plexaura sp.
Plla	Plexaurella sp.
Plum	Pseudaxinella lumaecharta
Pmam	Palythoa mammillosa
Pnin	Plexaura nina
Pnut	Plexaurella nutans
Pocr	Polycavernosa crassissima
Poly	Polycarpa sp.
Pori	Porites sp.
Poro	Porolithon sp.
Ppac	Porolithon pachydermum
Ppar	Parazoanthus parasiticus
Ppol	Polyphysa polyphysoides
Ppor	Porites porites
Ppue	Parazoanthus puertoricense
Ppyr	Penicillus pyriformis
Prot	Protula sp.
Psam	Pseudopterogorgia americana
Psan	Padina sanctae-crucis
Psbi	Pseudopterogorgia bipinnata
Psca	Pseudocorynactis caribbeorum
Pseu	Pseudoceratina sp.
Psia	Pseudopterogorgia sp.
Psla	Pseudaxinella sp.
Pspo	Pseudoplexaura porosa
Psra	Pseudoplexaura sp.
Pste	Pomatostegus stellatus
Pswi	Parazoanthus swiftii
Pter	Pterogorgia sp.
Ptil	Ptilocaulis sp.
Ptum	Polyandrocarpa tumida
Ptun	Parazoanthus tunicans
Pwag	Psuedoplexaura wagenaari
Pwal	Ptilocaulis walpersi
Rabd	Rhopalaea abdominalis
Reve	Reteporellina evelinae
Rflo	Ricordia florida
Rico	Ricordia sp.
Rint	Rosenvingea intricata
Rjun	Rhaphidophlus juniperinus
Rmac	Rhizosmilia maculata
Rose	Rosenvingea sp.
Rpho	Rhipocephalus phoenix
Rsan	Rhodactis sanctithomae
Rtom	Rhipilia tomentosa
Rven	Rhaphidophlus venosus
Salp	Salpa sp.
Sarg	Sargassum sp.
Sbou	Solenastrea bournoni
Scal	Schizothrix calcicola
Schi	Schizothrix sp.
Scoc	Spirastrella coccinea
Scol	Scolymia sp.
Scom	Scinaia complanata
Scor	Siphonodictyon coralliphagum
Scru	Scrupocellaria sp.
Scub	Scolymia cubensis
Scus	Spheciospongia cuspidifera
Sepi	Sporolithon episporum
Sexs	Swiftia exserta
Sfil	Syringodium filiforme
Sflu	Sargassum fluitans
Sgig	Spirobranchus giganteus
Shel	Stichodactyla helianthus
Shya	Solenastrea hyades
Shyp	Spyridia hypnoides
Shys	Sargassum hystrix
Side	Siderastrea sp.
Sint	Stephanocoenia intersepta
Slac	Scolymia lacera
Slut	Stichopathes lutkeni
Smag	Sabellastarte magnifica
Smic	Stephanocoenia michelini
Snat	Sargassum natans
Soff	Spongia officinalis
Sole	Solenastrea sp.
Spfi	Spyridia filamentosa
Spir	Spirobranchus sp.
Spla	Sargassum platycarpum
Spli	Spinosella plicifera
Spol	Sargassum polyceratium
Spte	Sargassum pteropleuron
Srad	Siderastrea radians
Sros	Stylaster roseus
Ssid	Siderastraea siderea
Stco	Stereotelesto corallina
Sthe	Stoichactis helianthus
Stma	Steginoporella magnilabris
Stoi	Stoichactis sp.
Ston	Strongylacidon sp.
Stro	Siphonocladus tropicus
Svag	Spinosella vaginalis
Sves	Spheciospongia vesparium
Svio	Schizoporella violacea
Svir	Symplegma viride
Swel	Scolymia wellsi
Swif	Swiftia sp.
Szon	Stypopodium zonale
Tame	Telmatactis americana
Taur	Tubastraea aurea
Tavi	Trematooecia aviculifera
Tber	Titanoderma bermudense
Tcoc	Tubastraea coccinea
Tele	Telesto sp.
Tfra	Titanideum frauenfeldii
Tfru	Telesto fruticulosa
Ther	Trichogloea herveyi
Tign	Tedania ignis
Tita	Titanoderma sp.
Tniv	Thesea nivea
Tped	Trichogloepsis pedicellata
Tpro	Titanoderma protopytum
Treq	Trichogloea requienii
Trii	Thalamophyllia riisei
Tsol	Trididemum solidum
Ttes	Thalassia testudinum
Ttri	Turbinaria tricostata
Ttur	Turbinaria turbinata
Turb	Turbinaria sp.
Tven	Tripneustes ventricosus
Ucya	Udotea cyathiformis
Udot	Udotea sp.
Ufas	Ulva fasciata
Ufla	Udotea flabellum
Uhis	Ulosa hispida
Ulac	Ulva lactuca
Ulva	Ulva sp.
Uocc	Udotea occidentalis
Uoxy	Ulvaria oxysperma
Urue	Ulosa ruetzleri
Uwil	Udotea wilsonii
Vaeg	Valonia aegagropila
Valo	Valonia sp.
Verm	Vermiliopsis sp.
Vero	Verongula sp.
Vgig	Verongula gigantea
Vglo	Viatrix globulifera
Vmac	Valonia macrophysa
Vrig	Verongula rigida
Vutr	Valonia utricularis
Vven	Ventricaria ventricosa
Warg	Wrangelia argus
Wblo	Wrightiella blodgettii
Wpen	Wrangelia penicillata
Wran	Wrangelia sp.
Xest	Xestospongia sp.
Xmut	Xestospongia muta
Zoan	Zoanthus sp.
Zpul	Zoanthus pulchellus
Zsoc	Zoanthus sociatus
